{
  "width": 16,
  "height": 16,
  "tileMap": [
    [ 0, 0, 0, 0, 0, 0, 0, 0, 0, 0, 0, 0, 0, 0, 0, 0 ],
    [ 0, 12, 2, 2, 0, 0, 0, 0, 0, 0, 0, 0, 0, 0, 0, 0 ],
    [ 0, 2, 3, 2, 2, 0, 0, 0, 0, 0, 3, 2, 2, 2, 0, 0 ],
    [ 0, 2, 2, 2, 2, 11, 2, 2, 2, 0, 0, 0, 2, 2, 0, 0 ],
    [ 0, 2, 2, 2, 2, 0, 0, 2, 2, 2, 3, 0, 2, 2, 0, 0 ],
    [ 0, 0, 0, 0, 0, 0, 0, 2, 0, 0, 2, 0, 0, 2, 0, 0 ],
    [ 0, 0, 2, 2, 0, 0, 2, 2, 2, 0, 2, 2, 0, 2, 2, 0 ],
    [ 0, 0, 2, 2, 11, 2, 2, 3, 2, 2, 2, 11, 0, 2, 2, 0 ],
    [ 0, 2, 2, 2, 0, 0, 2, 2, 2, 0, 2, 2, 0, 0, 11, 0 ],
    [ 0, 2, 2, 0, 0, 0, 0, 2, 0, 0, 0, 2, 2, 2, 2, 0 ],
    [ 0, 2, 2, 0, 0, 0, 0, 2, 0, 0, 0, 2, 0, 2, 2, 0 ],
    [ 0, 2, 2, 0, 0, 0, 0, 2, 0, 0, 0, 2, 0, 0, 0, 0 ],
    [ 0, 3, 2, 2, 11, 2, 2, 2, 2, 0, 2, 2, 2, 2, 2, 0 ],
    [ 0, 0, 12, 2, 2, 2, 2, 0, 2, 0, 2, 0, 0, 2, 2, 0 ],
    [ 0, 0, 0, 0, 0, 0, 0, 0, 2, 11, 2, 0, 0, 2, 1, 0 ],
    [ 0, 0, 0, 0, 0, 0, 0, 0, 0, 0, 0, 0, 0, 0, 0, 0 ]
  ]
}