{
  "width": 16,
  "height": 16,
  "tileMap": [
    [ 0, 0, 0, 0, 0, 0, 0, 0, 0, 0, 0, 0, 0, 0, 0, 0 ],
    [ 0, 2, 2, 2, 2, 2, 2, 2, 2, 2, 2, 2, 2, 2, 2, 0 ],
    [ 0, 2, 2, 0, 0, 0, 0, 2, 0, 2, 2, 2, 2, 2, 2, 0 ],
    [ 0, 2, 2, 0, 2, 4, 0, 2, 0, 2, 4, 2, 2, 0, 0, 0 ],
    [ 0, 2, 0, 0, 2, 2, 0, 2, 0, 2, 2, 2, 0, 0, 0, 0 ],
    [ 0, 2, 2, 2, 2, 0, 0, 2, 0, 0, 3, 0, 0, 2, 2, 0 ],
    [ 0, 2, 2, 2, 0, 0, 2, 2, 2, 0, 0, 0, 0, 2, 2, 0 ],
    [ 0, 2, 2, 2, 2, 2, 2, 1, 2, 2, 2, 2, 4, 2, 3, 0 ],
    [ 0, 2, 0, 0, 0, 0, 2, 2, 2, 0, 0, 0, 0, 2, 2, 0 ],
    [ 0, 2, 0, 2, 3, 0, 0, 2, 0, 0, 2, 2, 0, 2, 2, 0 ],
    [ 0, 2, 0, 2, 2, 2, 0, 2, 0, 2, 2, 3, 0, 0, 0, 0 ],
    [ 0, 2, 2, 2, 2, 2, 0, 2, 0, 2, 2, 2, 0, 0, 0, 0 ],
    [ 0, 4, 2, 0, 0, 0, 0, 2, 0, 0, 2, 0, 0, 2, 2, 0 ],
    [ 0, 2, 2, 2, 2, 2, 2, 4, 2, 2, 2, 0, 2, 2, 3, 0 ],
    [ 0, 2, 2, 2, 2, 2, 2, 2, 2, 2, 2, 2, 4, 2, 2, 0 ],
    [ 0, 0, 0, 0, 0, 0, 0, 0, 0, 0, 0, 0, 0, 0, 0, 0 ]
  ]
}