0000000000000000
0203202202222220
0202222200200200
0222200222402220
0202202202202320
0200000000000000
0202402222302220
0202000200002210
0202222422202220
0400002202200200
0002200200002230
0222202222202000
0203222020302420
0200000020000020
0224022222222220
0000000000000000